version:0.1
map_name:std.map
width:16
height:16
rubbish:10
map:
#,#,#,#,#,#,#,#,#,#,#,#,#,#,#,#,
#, , , , , , , , , , , , , , ,#,
#, , , , , , , , , , , , , , ,#,
#, , , , , , ,*, , , , , , , ,#,
#, , , , , , , , , , , , , , ,#,
#, , , , , , , , ,*, , , , , ,#,
#, , , ,*, , , , ,*, , , , , ,#,
#, , , , , , , , , , , , , , ,#,
#, , , , ,*, , , , , , , , , ,#,
#, , , , , , , , ,*, , , , , ,#,
#, , , , , , , ,*, , , , , , ,#,
#, , ,*, , , , , , , , , , , ,#,
#, , , , , ,*, , , , , , , , ,#,
#, , ,*, , , , , , , , , , , ,#,
#, , , , , , , , , , , , , , ,#,
#,#,#,#,#,#,#,#,#,#,#,#,#,#,#,#,