version:0.1
map_name:base.map
width:16
height:16
rubbish:10
gem:0
map:
#,#,#,#,#,#,#,#,#,#,#,#,#,#,#,#,
#, , , , , ,#, , , , , , ,#, ,#,
#, , , , , ,#,#,#, , , , ,#, ,#,
#, , , , , , , ,#, , , , ,#, ,#,
#, , , , , , , ,#,*, , , ,#, ,#,
#, , , , ,#,*, , , , ,#, ,#, ,#,
#,#,#,#,#,#, , , , , ,#, , , ,#,
#, , ,#,*, , , , , , ,#, , ,*,#,
#, , ,#,*, , , ,#,#,#,#,#,#,#,#,
#, , ,#, , , ,*,#, , , , , , ,#,
#, , ,#, , , , ,#, , ,*, , , ,#,
#,*, ,#, , , , ,#, , , , , , ,#,
#, , , , , ,#,#,#, , ,#, , , ,#,
#, , ,*, , , , , , , ,#, , , ,#,
#, , ,#, , , , ,*, , ,#, , , ,#,
#,#,#,#,#,#,#,#,#,#,#,#,#,#,#,#,