version:0.1
map_name:big.map
width:30
height:30
rubbish:27
gem:7
map:
#,#,#,#,#,#,#,#,#,#,#,#,#,#,#,.,.,.,.,.,.,.,#,#,#,#,#,#,.,.,
#,*, , , , ,*, , , , , , , ,#,.,.,.,.,.,.,.,#,#, , , ,#,.,.,
#,#,#,#,#,#,#, , , , ,#, ,#,#,#,#,.,.,.,.,.,#, , ,#, ,#,.,.,
.,.,.,.,.,.,#,#,#,#,#,#, ,#,#,#,#,.,.,.,.,.,#,#, ,#,#,#,.,.,
.,.,.,.,.,.,#, , , , , , ,#, , ,#,#,#,#,#,#,#, , ,#,.,.,.,.,
.,.,.,.,.,.,#, , ,*,#,#, ,#, , , , , , ,*, , ,*, ,#,.,.,.,.,
.,.,.,.,.,.,#, ,#, ,#,#, ,#, , , ,$, , , , ,#, , ,#,.,.,.,.,
#,#,#,#,#,#,#, ,#, , ,#, , , ,*, ,#,#,#,#,#,#,#, ,#,.,.,.,.,
#, ,#, , , ,#, ,#,#,#,#, , , , ,#,#,#,#,.,.,.,#,$,#,.,.,.,.,
#, , ,#, , ,#, ,#, , ,#,#,#,#,#,#, , ,#,.,.,.,#, ,#,#,#,.,.,
#, , , , , , , , ,#, , , , ,#, ,#, , ,#,.,.,.,#, , , ,#,.,.,
#,#,#, ,#, ,#, , ,#, , ,*,#,#, ,#,*, ,#,.,.,.,#, ,*, ,#,.,.,
.,.,#, ,#, ,#, , , ,*, ,*, , , , , , ,#,.,.,.,#,#,#,#,#,.,.,
.,.,#,#,#, ,#,$, , , , , , , , ,$, , ,#,#,#,#,#,#,#,.,.,.,.,
.,.,#,#, , ,#,#,#,#,#,#,#,#,#,#,#, , ,#, ,#, ,*,#,#,.,.,.,.,
.,.,#, ,*, , , , ,#, ,#,.,.,.,.,.,#, ,#, , , ,*, ,#,.,.,.,.,
.,.,#, , , ,#,#, ,#, ,#,.,.,.,.,.,#, ,#, ,#,*, ,#,#,.,.,.,.,
#,#,#,#,#, ,*,#, ,#, ,#,.,.,.,.,.,#, , , ,#, , ,#,#,.,#,#,#,
#, , ,#,#, , ,#,*,#, ,#,.,.,.,.,.,#, ,*, ,#, , ,#,#,.,#,*,#,
#, ,*, , , , ,#, ,#, ,#,.,.,.,.,.,#,#,#, , ,#, ,#,#,.,#, ,#,
#, , ,#,#,#,#,#, , , ,#,.,.,.,.,.,#,#,#, ,#,#,#, ,#,#,#, ,#,
#,#, ,#,.,.,.,#, , , ,#,.,.,.,.,.,#, ,#, , , , , ,*, , , ,#,
#,#, ,#,.,.,.,#, ,#,#,#,.,.,.,.,.,#, ,#, ,#,#,$, , , ,#, ,#,
#, , ,#,.,.,.,#, , , ,#,.,.,.,.,.,#, , , ,#,#,#,#,#,#,#, ,#,
#,*,$,#,.,.,.,#,#, ,#,#,.,.,.,.,.,#,#, ,*, ,#,#,.,.,.,#, ,#,
#, ,#,#,.,.,.,#, ,*,#,#,.,.,.,.,.,#,#, , ,$, ,#,.,.,.,#, ,#,
#, , ,#,.,.,.,#, , ,#,.,.,.,.,.,.,.,#, ,*, , ,#,.,.,.,#, ,#,
#,#,*,#,.,.,.,#,#, ,#,.,.,.,.,.,.,.,#, , ,#, ,#,.,.,.,#,*,#,
#, , ,#,.,.,.,#, , ,#,.,.,.,.,.,.,.,#, , , ,#,#,.,.,.,#, ,#,
#,#,#,#,.,.,.,#,#,#,#,.,.,.,.,.,.,.,#,#,#,#,#,#,.,.,.,#,#,#,