version:0.1
map_name:comp.map
width:27
height:30
rubbish:38
gem:5
map:
#,#,#,#,#,.,.,.,.,.,.,#,#,#,#,#,.,.,.,.,.,.,.,.,.,.,.,
#, ,*, ,#,.,.,.,.,.,.,#, , , ,#,#,#,#,#,.,.,.,.,.,.,.,
#, ,*, ,#,.,.,.,.,.,.,#, , , ,#, , , ,#,.,.,.,.,.,.,.,
#, , , ,#,#,#,#,#,.,.,#, ,$, , , ,*, ,#,.,.,.,.,.,.,.,
#, ,*, ,*, , ,*,#,.,.,#,*, , , , , , ,#,.,.,.,.,.,.,.,
#, , ,#,#, , , ,#,.,.,#, , ,*,#, ,*, ,#,.,.,#,#,#,#,.,
#,*, ,#,#,#, , ,#,#,#,#, , , ,#,#,#,#,#,.,.,#, , ,#,.,
#, , , ,#,#, , , , , , , , , ,#,.,.,.,.,.,.,#, , ,#,.,
#, , , , , ,#,#,#,#, ,*, ,#,#,#,.,.,.,.,.,.,#, , ,#,#,
#,#,#,#,#, ,#,.,.,#,*, , ,#,.,.,.,.,.,.,.,#,#,*, , ,#,
.,.,.,.,#, ,#,#,#,#,*, , ,#,.,.,.,.,.,.,.,#, ,*,$, ,#,
.,.,.,.,#, , , , , , , , ,#,#,#,#,#,#,#,.,#, , , , ,#,
.,.,.,.,#,#,#,#,#,#, ,*,*, , ,#, , , ,#,.,#,#,#,#,#,#,
.,.,.,.,.,.,.,.,.,#, , ,*, , ,#, , , ,#,.,.,.,.,.,.,.,
.,.,.,.,.,.,.,#,#,#, , , , ,*,#, ,*, ,#,.,.,.,#,#,#,.,
.,.,.,.,.,.,.,#,#,#,#,#, , ,#,#, , , ,#,.,.,.,#, ,#,.,
#,#,#,#,#,#,#,#, , , , , , , , , , , ,#,.,.,#,#, ,#,.,
#, ,#, , , , , , , , , ,*, ,*, , ,#,#,#,.,.,#, , ,#,#,
#, ,#, ,*, , , , ,*, , , , , , ,*, , ,#,#,#,#,*, , ,#,
#, , , ,*,#,*, , , ,$, ,#,#,#,#, , , , , , , , ,*,#,#,
#, , , , ,#, , , , , , , , , ,#, , , ,#,#,#,#, ,*,#,.,
#,#,#,#,#,#,#,#,#,#,#, , , , ,#, ,#,#,#,.,.,#,#,#,#,.,
.,.,.,.,.,.,.,.,.,.,#, ,$, , , , , ,#,.,.,.,.,.,.,.,.,
.,.,.,.,.,.,.,.,.,.,#, , , , , , , ,#,.,.,.,.,.,.,.,.,
.,.,.,#,#,#,#,#,#,#,#, , ,*, , ,*, ,#,#,#,#,.,.,.,.,.,
.,.,.,#, , , , , ,*, ,*, , , , , , , , , ,#,.,.,.,.,.,
.,.,.,#, , ,*, , , , , , , , , ,*, ,$, ,*,#,.,.,.,.,.,
.,.,.,#,#,#,#,#,#,#,#,#,#,#, , ,*, , , , ,#,.,.,.,.,.,
.,.,.,.,.,.,.,.,.,.,.,.,.,#, , , , , , , ,#,.,.,.,.,.,
.,.,.,.,.,.,.,.,.,.,.,.,.,#,#,#,#,#,#,#,#,#,.,.,.,.,.,