version:0.1
map_name:long.map
width:40
height:16
rubbish:25
gem:5
map:
#,#,#,#,#,#,#,#,#,#,#,#,#,#,.,.,.,.,.,#,#,#,#,#,#,#,.,.,.,.,.,.,.,#,#,#,#,#,#,.,
#, , , , ,$, , , , ,*, , ,#,#,#,#,#,#,#, , , , , ,#,.,.,.,.,.,.,.,#, , , , ,#,.,
#, , ,#, ,#,#,#,#, , , , , , , , , , , , , , ,*, ,#,.,.,.,.,.,.,.,#, , , ,#,#,.,
#, , ,#, ,*, ,#,#, ,#,#,#,#,#,#,#,#,#,#,#,#,#, , ,#,#,#,#,#,#,#,#,#, ,*,#,#,#,.,
#,$, ,#, , , ,#,#, ,#, , ,*, , , , , , , , , , , ,#, , , ,#,#,#,#, , ,#,#,#,#,.,
#, , ,#,#,#, , , ,#,#, ,*, , ,#, , ,#,#,#,#, ,*, , , , ,$,#,#,#,#, ,*, ,*, ,#,.,
#, , , , ,#, , , , ,#, , ,*,#,#, , ,#,#,#,#, , ,#,#,#,#, , , , , , , , , , ,#,.,
#, , , , ,#,#,#, , , ,#, ,#,#,#, ,$, , , , , , ,#,#,#,#, , ,*, ,#,#,#,#,*, ,#,.,
#, ,*, , ,#,#,#, ,*, ,#,#,#,#,#, ,#,#,#,#,#,#, ,#,#,#,#, ,#, ,#,#,*,*,#, , ,#,.,
#, ,*,*, , , ,#,#, , , , , , , , ,#,.,.,.,.,#, ,#,#,#,#, ,#, ,#,#, , , , , ,#,.,
#, , , , ,*, ,#,#, , ,#,#,#,#, , ,#,.,.,.,.,#, ,#,#,#, , ,#, ,#,#, ,#,#,#,#,#,.,
#, , ,#,#, , , ,#, ,*,#,#,#,#, , ,#,.,.,.,.,#, , , , , ,*,#, , ,#, ,#,.,.,.,.,.,
#, ,*,#,#, ,*, ,#, , ,#,#,#,#, , ,#,.,.,.,.,#, , , ,*, , ,#, , ,#, ,#,.,.,.,.,.,
#, , ,#,#,#,#,#,#, , , , , , , , ,#,.,.,.,.,#,#,#,#,#,#,#, ,*, ,#, ,#,#,#,#,#,#,
#, , , , , , , , , , ,#,#,#, , , ,#,.,.,.,.,.,.,.,.,.,#, , , ,$, , , , , , , ,#,
#,#,#,#,#,#,#,#,#,#,#,#,#,#,#,#,#,#,.,.,.,.,.,.,.,.,.,#,#,#,#,#,#,#,#,#,#,#,#,#,