version:0.1
map_name:shizi.map
width:20
height:20
rubbish:26
map:
#,#,#,#,#,#,#,#,#,#,#,#,#,#,#,#,.,.,.,.,
#, , ,*, , ,#,#, , , , , , , ,#,.,.,.,.,
#, , , , , , , , ,#,#,#,#, , ,#,.,.,.,.,
#,#,#,#,#, , , , ,#,.,.,#,#, ,#,.,.,.,.,
.,.,.,.,#, ,*, ,#,#,.,.,.,#,#,#,#,#,#,#,
.,.,.,.,#, , , ,#,.,.,.,.,.,#, , , , ,#,
.,.,.,.,#,*, , ,#,.,.,.,.,.,#, , , , ,#,
.,.,.,.,#, , ,*,#,#,#,#,#,.,#, , ,*, ,#,
.,.,.,.,#, , , ,#, , ,*,#,.,#, ,*, , ,#,
#,#,#,#,#, ,#,#,#,*, , ,#,#,#, , ,*, ,#,
#, , , ,*, ,#,#, ,*,*,*,*,*, , , ,*, ,#,
#, , , , , ,*, , , , , , , ,#,#,#,#,#,#,
#, , , , ,*, , , , , ,#, , ,#,.,.,.,.,.,
#,#,#,#,#,#,#, , ,#, ,#, ,*,#,.,#,#,#,.,
.,.,.,.,.,.,#, ,*,#,#,#, , ,#,.,#, ,#,.,
.,.,.,.,.,.,#, , ,#, , ,*,*,#,.,#, ,#,#,
.,.,.,.,.,.,#, , ,#, , , , ,#,.,#,*, ,#,
.,.,.,.,.,.,#, ,*, , , , , ,#,#,#, ,*,#,
.,.,.,.,.,.,#, , , ,*, , , , , , , , ,#,
.,.,.,.,.,.,#,#,#,#,#,#,#,#,#,#,#,#,#,#,