version:0.1
map_name:some.map
width:16
height:16
rubbish:20
map:
#,#,#,#,#,#,#,#,#,#,#,#,#,#,#,#,
#, , , , , , , , , , , , , , ,#,
#, , , , , , , , , , , , , , ,#,
#, , , , , , , , , , , , , , ,#,
#, , , , , , , , , , , , , , ,#,
#, , , , , , , , , , , , , , ,#,
#, , , , , , , , , , , , , , ,#,
#, , , , , , ,*,*,*, , , , , ,#,
#,*, , , , , , , , , , , , , ,#,
#, , , , ,*, , , , , , , , , ,#,
#, , , , , , ,*, , , , , , , ,#,
#, ,*, , , , , , , ,*, , , , ,#,
#, , ,*, , , , , , , , , , , ,#,
#, , , , , , ,*, , , , , , , ,#,
#, , , , , , , , , , , , , , ,#,
#,#,#,#,#,#,#,#,#,#,#,#,#,#,#,#,