version:0.1
map_name:xxx.map
width:16
height:16
rubbish:28
gem:0
map:
#,#,#,#,#,#,#,#,#,#,#,#,#,#,#,#,
#, , , , , , , ,*, , , , , ,*,#,
#, , , , ,*, , , , , , , , , ,#,
#, ,*, , , , , , , , , , ,*, ,#,
#, , , ,*, , , , , , , , , , ,#,
#, ,*, , , , ,*, , , ,*, , , ,#,
#, , , ,*, , , , , , , , , ,*,#,
#,*, , , , , , ,*, , , , , , ,#,
#, , , , , ,*, , ,*, ,*, , , ,#,
#, ,*, , ,*, , , ,*, , , , , ,#,
#,*, , , , , , , , , , , , , ,#,
#, , , , , , ,*, , , , , , , ,#,
#, , , , , , , , , , , , ,*, ,#,
#, ,*, , , ,*, , ,*, , , , , ,#,
#, , , , , , , ,*, ,*, , ,*, ,#,
#,#,#,#,#,#,#,#,#,#,#,#,#,#,#,#,